,Year,Fatality,SevereInjury,MinorInjury,PersonsAffected,Total RTC
0,2010,228,558,5514,6300,323383
1,2011,205,584,5558,6347,316884
2,2012,204,608,5602,6414,296165
3,2013,235,650,5647,6532,290254
4,2014,228,694,5691,6613,273551
5,2015,227,693,5129,6049,267052
6,2016,178,871,5311,6360,246333
7,2017,177,741,5319,6237,240422
8,2018,168,684,5473,6325,223719
9,2019,154,778,5829,6761,217220
10,2020,138,572,5097,5807,155630
